//MAP CONVERTED BY dmm2tgm.py THIS HEADER COMMENT PREVENTS RECONVERSION, DO NOT REMOVE
"a" = (
/obj/item/storage/backpack/satchel/flat/secret{
	reward_all_of_these = list(/obj/item/gun/energy/pulse/prize)
	},
/turf/template_noop,
/area/template_noop)

(1,1,1) = {"
a
"}
